28
31
****************************
*            **            *
* **** ***** ** ***** **** *
*P**** ***** ** ***** ****P*
* **** ***** ** ***** **** *
*                          *
* **** ** ******** ** **** *
* **** ** ******** ** **** *
*      **    **    **      *
****** *****E**E***** ******
EEEEE* *****E**E***** *EEEEE
EEEEE* **EEEEEEEEEE** *EEEEE
EEEEE* **E***EE***E** *EEEEE
****** **E*EEEEEE*E** ******
LEEEEE EEE*EEEEEE*EEE EEEEER
****** **E*EEEEEE*E** ******
EEEEE* **E********E** *EEEEE
EEEEE* **EEEEEEEEEE** *EEEEE
EEEEE* **E********E** *EEEEE
****** **E********E** ******
*            **            *
* **** ***** ** ***** **** *
* **** ***** ** ***** **** *
*P  **        S       **  P*
*** ** ** ******** ** ** ***
*** ** ** ******** ** ** ***
*      **    **    **      *
* ********** ** ********** *
* ********** ** ********** *
*                          *
****************************