28
31
5AAAAAAAAAAAA65AAAAAAAAAAAA6
L            RL            R
L 1BB2 1BBB2 RL 1BBB2 1BB2 R
LPREEL REEEL RL REEEL REELPR
L 4AA3 4AAA3 43 4AAA3 4AA3 R
L                          R
L 1BB2 12 1BBBBBB2 12 1BB2 R
L 4AA3 RL 4AA65AA3 RL 4AA3 R
L      RL    RL    RL      R
8BBBB2 R8BB2ERLE1BB7L 1BBBB7
EEEEEL R5AA3E43E4AA6L REEEEE
EEEEEL RLEEEEEEEEEERL REEEEE
EEEEEL RLE1BBEEBB2ERL REEEEE
AAAAA3 43EREEEEEELE43 4AAAAA
[EEEEE EEEREEEEEELEEE EEEEE]
BBBBB2 12EREEEEEELE12 1BBBBB
EEEEEL RLE4AAAAAA3ERL REEEEE
EEEEEL RLEEEEEEEEEERL REEEEE
EEEEEL RLE1BBBBBB2ERL REEEEE
5AAAA3 43E4AA65AA3E43 4AAAA6
L            RL            R
L 1BB2 1BBB2 RL 1BBB2 1BB2 R
L 4A6L 4AAA3 43 4AAA3 R5A3 R
LP  RL       SE       RL  PR
8B2 RL 12 1BBBBBB2 12 RL 1B7
5A3 43 RL 4AA65AA3 RL 43 4A6
L      RL    RL    RL      R
L 1BBBB78BB2 RL 1BB78BBBB2 R
L 4AAAAAAAA3 43 4AAAAAAAA3 R
L                          R
8BBBBBBBBBBBBBBBBBBBBBBBBBB7