13
11
*************
*           *
* **** **** *
* **** **** *
* **** **** *
L           R
* **** **** *
* **** **** *
* **** **** *
*           *
*************